final i is always omitted
when that results in one consonant, /ʏ/ <y> is added on.
/u/ > /ʊ/
/l/ > /ɾ/
-mu suffix is added on wan, tu to make 3 and 4
-su suffix is added on wan, tu to make 5 and 6
-ma suffix is added on wan, tu to make 7 and 8
-sa suffix is added on wan, tu to make 9 and 0
(the numbers are formed digit by digit, eg: 54 = wansu-tumu)

i//_#
/y/#C_#

a → a
akesi → akes
ala → ala
alasa → alasa
ale/ali → ale/al
anpa → anpa
ante → ante
anu → anu
awen → awen
e → e
en → en
esun → esun
ijo → ijo
ike → ike
ilo → ilo
insa → insa
jaki → jak
jan → jan
jelo → jelo
jo → jo
kala → kala
kalama → kalama
kama → kama
kasi → kas
ken → ken
kepeken → kepeken
kili → kil
kin → kin
ko → ko
kon → kon
kule → kule
kute → kute
kulupu → kulupu
la → la
lape → lape
laso → laso
lawa → lawa
len → len
lete → lete
li → ly
lili → lil
linja → linja
lipu → lipu
loje → loje
lon → lon
luka → luka
lukin → lukin
lupa → lupa
ma → ma
mama → mama
mani → man
meli → mel
mi → my
mije → mije
moku → moku
moli → mol
monsi → mons
mu → mu
mun → mun
musi → mus
mute → mute
nanpa → nanpa
nasa → nasa
nasin → nasin
nena → nena
ni → ny
nimi → nim
noka → noka
o → o
oko → oko
olin → olin
ona → ona
open → open
pakala → pakala
pali → pal
palisa → palisa
pan → pan
pana → pana
pi → py
pilin → pilin
pimeja → pimeja
pini → pin
pipi → pip
poka → poka
poki → pok
pona → pona
sama → sama
seli → sel
selo → selo
seme → seme
sewi → sew
sijelo → sijelo
sike → sike
sin → sin
sina → sina
sinpin → sinpin
sitelen → sitelen
sona → sona
soweli → sowel
suli → sul
suno → suno
supa → supa
suwi → suw
tan → tan
taso → taso
tawa → tawa
telo → telo
tenpo → tenpo
toki → tok
tomo → tomo
tu → tu
unpa → unpa
uta → uta
utala → utala
walo → walo
wan → wan
waso → waso
wawa → wawa
weka → weka
wile → wile
